ADV:mente	adveb ending in -mente
AUX:fin		finite form of auxiliary
AUX:fin:cli	finite form of auxiliary with clitic
AUX:geru	gerundive form of auxiliary
AUX:geru:cli	gerundive form of auxiliary with clitic
AUX:infi	infinitival form of auxiliary
AUX:infi:cli	infinitival form of auxiliary with clitic
AUX:ppast	past participle of auxiliary
AUX:ppre	present participle of auxiliary
CHE		che
CLI		clitic
CON		conjunction
DET:wh		wh determiner
NEG		negation
NOCAT		non-linguistic element
PRO:num		numeral pronoun
VER2:fin	finite form of modal/causal verb
VER2:fin:cli	finite form of modal/causal verb with clitic
VER2:geru	gerundive form of modal/causal verb
VER2:geru:cli	gerundive form of modal/causal verb with clitic
VER2:infi	infinitival form of modal/causal verb
VER2:infi:cli	infinitival form of modal/causal verb with clitic
VER2:ppast	past participle of modal/causal verb
VER2:ppre	present participle of modal/causal verb
VER:fin		finite form of verb
VER:fin:cli	finite form of verb with clitic
VER:geru	gerundive form of verb
VER:geru:cli	gerundive form of verb with clitic
VER:infi	infinitival form of verb
VER:infi:cli	infinitival form of verb with clitic
VER:ppast	past participle of verb
VER:ppast:cli	past participle of verb with clitic
VER:ppre	present participle of verb
WH		wh word